11111111111111111111
1S000000100000000001
10101111100000000001
10100000000000000001
10100000000000000001
10100000000000000001
10100000000000000001
10100000000000000001
10100000000000000001
10100000000000000001
10100000000000000001
10100000000000000001
10100000000000000001
10100000000000000001
10100000000000000001
10100000000000000001
10100000000000000001
10111111111111111111
100000000000000000G1
11111111111111111111
