11111111111111111111
1S000000000000000001
10111111111111111101
10100000000000000001
10100000000000011111
10100000000000000001
10100000000000000101
10100000000000000101
10100000000000000101
10100000000000000101
10100000000000000101
10100000000000000101
10100000000000000101
10100000000000000101
10100000000000000101
10100000000000000101
10100000000000000101
10100000000000000101
100000000000000001G1
11111111111111111111
