11111111111111111111
1S000000000000000001
10111111111111111101
10100000000000000001
10100000000000000001
10100000000000000001
10100000000000000001
10100000000000000001
10100000000000000001
10000000000000000001
10100000000000000001
10100000000000000001
10100000000000000001
10100000000000000001
10100000000000000001
10100000000000000001
10100000000000000001
10111111111111111111
100000000000000000G1
11111111111111111111
