11111111111111111111
1S000000000000000001
10000000000000000001
10111111111111111111
10100000000000000001
10100000000000000001
10000000000000000001
10000000000000000001
10111111111111111001
10100000000000001001
10100000000000000001
10100000000000001001
10100000000000001001
11111111111111111001
10000000000000000001
10000000000000000001
10111111111111111001
10000000000000001001
100000000000000010G1
11111111111111111111
