11111111111111111111
1S000000000000000001
10000000000000000101
10000000000000000101
10000000000000010101
10000000000000100101
10000000000001000101
10000000000010000101
10000000000100000101
10000000001000000101
10000000010000000101
10000000100000000101
10000001000000000101
10000010000000000101
10000100000000000101
10001000000000000101
10010000000000000101
10000000000000000101
100000000000000001G1
11111111111111111111
